111111111111111111111111111111111111111111111111111
1CCCC1WWW000C00000000000000000000111111000010010101
1000000000000000000001C00C00WW0W0000000000000000001
100000000000000000000111111111100000000000000000001
100000000000000000000000000000001000001000000000001
10000E0000000CCC0C000000000000001011101000000W00001
100000000000000000000000000000001C10101000WCWC00001
100000000000000000CW0C00C00000001110000000C1CWW00C1
100000000000000000WC10C000000000100000000001WCWWWW1
100000000000000000CW100000000000000000000000CC10001
100000W000000000011111111111100000W0000000000000001
10000PWWW1000001000001CCCC1WWW000C00000000000000001
1000000000000000000001C00C00WW0W0000000000000000001
1000000000000000000001111110000W1100000000W1W11W1W1
111111111111111111111111111111111111111111111111111